South La Union Campus (CGS) Programs and Chairpersons: PhD Educational Administration: Dr. Paulo Jan F. Samson
PhD Science Education: Dr. Flordiliza B. Dalumay
PhD Mathematics Education: Dr. Ryan L. Cerveza
Master in Development Administration: Dr. Janice Rhea P. Cabacungan
MA Guidance & Counseling: Prof. Maria Elena V. Milan
MA Educational Management: Dr. Rodelio V. Indong
MA Special Education: Prof. Jennilyn R. Calimquim
MA Science Education: Dr. Maria Cristina B. Bandarlipe
MA Mathematics Education: Dr. Jefferson D. Isidro
MA Language Teaching: Dr. Fe M. Tangalin
MA Teaching Music: Dr. Bienvenido B. Constantino, Jr.
MA Physical Education: Dr. Ana Maria L. Demot
MA Technology & Livelihood Education: Dr. Veronica B. Carbonell
MS Computer Science: Dr. Clarissa V. Albarillo
MS Biology: Dr. Precelita L. Osillos
MS Fisheries: Dr. Reginor Lyzza A. Roque

College of Computer Science (CCS)
Programs and Chairpersons:
BS Computer Science: Prof. Raymund E. Dilan

College of Agriculture (CA)
Programs and Chairpersons:
BS Agriculture: Prof. Socorro L. Rulloda

College of Fisheries (CF)
Programs and Chairpersons:
BS Fisheries: Prof. Aphrodite S. Entoma

College of Community Health and Allied Medical Sciences (CCHAMS)
Programs and Chairpersons:
BS Nursing: Prof. Jovencio M. Milan, Jr.
BS Midwifery: Prof. Gina L. Domondon

College of Arts and Sciences (CAS)
Programs and Chairpersons:
BS Biology: Dr. Precelita L. Osillos
BS Mathematics: Prof. Daisy Ann A. Disu
BS Psychology: Prof. Yezza E. Sindayen
BA English Language: Dr. Manilyn R. Cacanindin
BA Communication: Dr. Ernesto C. Collo, Jr.
BS Filipino: Prof. Magdalena C. Mangaoang

College of Education (CE)
Programs and Chairpersons:
BSEd: Prof. John Mark G. Lachica
BTLEd: Dr. Veronica B. Carbonell
BSNEd: Prof. Junabel F. Dy
BEEd: Prof. Zita D. Ballesteros
BCAEd: Prof. Renan N. Flores
BPEd: Prof. Jocelyn A. Floresca
BECEd: Prof. Alexander S. Lopez
Elementary Principal: Prof. Myrna O. Acas
High School Principal: Prof. Jan Kenneth R. Laguardia

College of Medicine (COM)
Programs and Chairpersons:
Doctor of Medicine: Dr. Ricardo S. Guanzon