Mid La Union Campus (CGS)
Programs and Chairpersons:
PhD Development Administration: Dr. Josephine V. Gimpaya
PhD Mathematics Education: Dr. Noemi M. Boado
PhD Science Education: Dr. Jayson O. Madayag
PhD Technology Education Management: Dr. Manolito F. Dela Cruz
MA Mathematics Education: Dr. Ma. Teresa Y. Acantilado
Master in Development Administration: Dr. Josephine V. Gimpaya
Master in Information Technology: Dr. Mark Kristian C. Ledda
Master in Management Engineering: Dr. Grace A. Llobrera-Diamse

College of Law (CLAW)
Programs and Chairpersons:
Juris Doctor (JD): Atty. Honorio G. Buccat, Jr.

College of Information Technology (CIT)
Programs and Chairpersons:
BS Information Technology: Dr. Sheena I. Sapuay-Guillen

College of Engineering (COE)
Programs and Chairpersons:
BSEE: Engr. Ariel V. Canedo
BSME: Engr. Melchor C. Meana

College of Arts and Sciences (CAS)
Programs and Chairpersons:
BS Psychology: Asst. Prof. Renz Arvin C. Dumaguin
BA Political Science: Dr. Dulce M. Rodriguez
BA English Language: Dr. Rinarose B. Budeng
BS Filipino: Asst. Prof. Charity P. Madayag
General Education: Asst. Prof. Benedick Adrian Flores

College of Education (CE)
Programs and Chairpersons:
BSEd: Dr. Vanessa P. Cayabyab
BTVTEd, BTLEd: Asso. Prof. Myal A. Guba
BEEd, BECEd: Dr. Alfonso S. Lopez
BPEd: Mr. Danny M. Bagano
Elementary Principal: Dr. Sharlane Elaine Gay V. Fabrigay
High School Principal: Asst. Prof. Ace T. Ceremonia

College of Management (COM)
Programs and Chairpersons:
BPA: Asst. Prof. Marifel D. Ancheta
BSBA: Asst. Prof. Daniel B. Gacayan
BSHM: Ms. Zhelyn D. Hufana
BSOA: Asst. Prof. Annaliza B. Legazpi

Institute of Criminal Justice Education (ICJE)
Programs and Chairpersons:
BSCrim: Asst. Prof. Aurora R. Laroya

College of Technology (COT)
Programs and Chairpersons:
BS Industrial Technology: Dr. Jake Tyrone I. Somera
BS ElectroMechanical Technology: Dr. Jerry P. Carreon
BS Food Technology: Dr. Imma Concepcion G. Estabillo
BS Textile and Fashion Technology: Dr. Florentina A. Corpuz
BSIT-ETEEAP: Dr. Jake Tyrone I. Somera